DDDDDDDD DDDDDDDD DDDDDDDD DDDDDDDD
DDDDDDDD DDDDDDDD DDDDDDDD DDDDDDDD
DDDDDDDD DDDDDDDD DDDDDDDD DDDDDDDD
DDDDDDDD DDDDDDDD DDDDDDDD DDDDDDDD
AAAAAAAA AADAAAAA AAAAADAA AAAAAAAA
AAAAAAAA AADAAAAA AAAAADAA AAAAAAAA
AAAAAAAA AADAAAAA AAAAADAA AAAAAAAA
AAAAAAAA AADAAAAA AAAAADAA AAAAAAAA
AAAAAAAA AADAAAAA AAAAADAA AAAAAAAA
AAAAAAAA AADAAAAA AAAAADAA AAAAAAAA
AAAAAAAA AADAAAAA AAAAADAA AAAAAAAA
AAAAAAAA AADAAAAA AAAAADAA AAAAAAAA
AAAAAAAA AADAAAAA AAAAADAA AAAAAAAA
AAAAAAAA AADAAAAA AAAAADAA AAAAAAAA
AAAAAAAA AADAAAAA AAAAADAA AAAAAAAA
DDDDDDDD DDDAAAAA AAAAADDD DDDDDDDD
DDDDDDDD DDDAAAAA AAAAADDD DDDDDDDD
AAAAAAAA AADAAAAA AAAAADAA AAAAAAAA
AAAAAAAA AADAAAAA AAAAADAA AAAAAAAA
AAAAAAAA AADAAAAA AAAAADAA AAAAAAAA
AAAAAAAA AADAAAAA AAAAADAA AAAAAAAA
AAAAAAAA AADAAAAA AAAAADAA AAAAAAAA
AAAAAAAA AADAAAAA AAAAADAA AAAAAAAA
AAAAAAAA AADAAAAA AAAAADAA AAAAAAAA
AAAAAAAA AADAAAAA AAAAADAA AAAAAAAA
AAAAAAAA AADAAAAA AAAAADAA AAAAAAAA
AAAAAAAA AADAAAAA AAAAADAA AAAAAAAA
AAAAAAAA AADAAAAA AAAAADAA AAAAAAAA
AAAAAAAA AADAAAAA AAAAADAA AAAAAAAA
AAAAAAAA AADAAAAA AAAAADAA AAAAAAAA
AAAAAAAA AADAAAAA AAAAADAA AAAAAAAA
AAAAAAAA AADAAAAA AAAAADAA AAAAAAAA
