AAAAAAAA AAAAAAAA AAAAAAAA AAAAAAAA
AAAAAAAA AAAAAAAA AAAAAAAA AAAAAAAA
AAAAAAAA AAAAAAAA AAAAAAAA AAAAAAAA
AAAAAAAA AAAAAAAA AAAAAAAA AAAAADAA
AADADADD DDADDDAD DDDDDADD DDDDDDDD
DDDDDDDD DDADDDDD DDDDDADD DDDDDDDD
DDDDDDDD DDADDDDD DDDDAADD DDDDDDDD
DDDDDDDD DDADDDDD DDDDDADD DDDDDDDD
DDDDDDDD DDADDDDD DDDDDADD DDDDDDDD
DDDDDDDD DDADDDDD DDDDDADD DDDDDDDD
DDDDDDDD DDADDDDD DDDDDADD DDDDDDDD
DADDDDDD DDADDDDD DDDDDADD DDDDDDDD
AAADDAAA ADADAADD AAAADADA DDDDADDD
AAAAAAAA ADAAAAAA AAAADAAA AAAAAAAD
AAAAAAAA ADAAAAAA AAAADAAA AAAAAAAD
AAAAAAAA AAAAAAAA AAAADAAA AAAAAAAA
AAAAAAAA AAAAAAAA AAAADAAA AAAAAAAA
AAAAAAAA ADAAAAAA AAAADAAA AAAAAAAD
AAAAAAAA ADAAAAAA AAAADAAA AAAAAAAD
AAAAAAAA ADAAAAAA AAAADAAA AAAAAAAD
AAAAAAAA ADAAAAAA AAAADAAA AAAAAAAD
AAAAAAAA ADAAAAAA AAAADAAA AAAAAAAD
AAAAAAAA ADAAAAAA AAAADAAA AAAAAAAD
AAAAAAAA ADAAAAAA AAAADAAA AAAAAAAD
AAAAAAAA ADAAAAAA AAAADAAA AAAAAAAD
AAAAAAAA ADAAAAAA AAAADAAA AAAAAAAD
AAAAAAAA ADAAAAAA AAAADAAA AAAAAAAD
AAAAAAAA ADAAAAAA AAAADAAA AAAAAAAD
AAAAAAAA ADAAAAAA AAAADAAA AAAAAAAD
AAAAAAAA ADAAAAAA AAAADAAA AAAAADAD
AAAAAAAA ADAAAAAA AAAADAAA AAAAAAAD
AAAAAAAA ADAAAAAA AAAADAAA AAAAADAD
