AAAAAAAA AADAAAAA AAAAADAA AAAAAAAA
AAAAAAAA AADAAAAA AAAAADAA AAAAAAAA
AAAAAAAA AADAAAAA AAAAADAA AAAAAAAA
AAAAAAAA AADAAAAA AAAAADAA AAAAADAA
AADADADD DDDDDDAD DDDDDDDD DDDDDDDD
DDDDDDDD DDDDDDDD DDDDDDDD DDDDDDDD
DDDDDDDD DDDDDDDD DDDDADDD DDDDDDDD
DDDDDDDD DDDDDDDD DDDDDDDD DDDDDDDD
DDDDDDDD DDDDDDDD DDDDDDDD DDDDDDDD
DDDDDDDD DDDDDDDD DDDDDDDD DDDDDDDD
DDDDDDDD DDDDDDDD DDDDDDDD DDDDDDDD
DADDDDDD DDDDDDDD DDDDDDDD DDDDDDDD
AAADDAAA ADDDAADD AAAADDDA DDDDADDD
AAAAAAAA ADDAAAAA AAAADDAA AAAAAAAD
AAAAAAAA ADDAAAAA AAAADDAA AAAAAAAD
DDDDDDDD DDDAAAAA AAAADDDD DDDDDDDD
DDDDDDDD DDDAAAAA AAAADDDD DDDDDDDD
AAAAAAAA ADDAAAAA AAAADDAA AAAAAAAD
AAAAAAAA ADDAAAAA AAAADDAA AAAAAAAD
AAAAAAAA ADDAAAAA AAAADDAA AAAAAAAD
AAAAAAAA ADDAAAAA AAAADDAA AAAAAAAD
AAAAAAAA ADDAAAAA AAAADDAA AAAAAAAD
AAAAAAAA ADDAAAAA AAAADDAA AAAAAAAD
AAAAAAAA ADDAAAAA AAAADDAA AAAAAAAD
AAAAAAAA ADDAAAAA AAAADDAA AAAAAAAD
AAAAAAAA ADDAAAAA AAAADDAA AAAAAAAD
AAAAAAAA ADDAAAAA AAAADDAA AAAAAAAD
AAAAAAAA ADDAAAAA AAAADDAA AAAAAAAD
AAAAAAAA ADDAAAAA AAAADDAA AAAAAAAD
AAAAAAAA ADDAAAAA AAAADDAA AAAAADAD
AAAAAAAA ADDAAAAA AAAADDAA AAAAAAAD
AAAAAAAA ADDAAAAA AAAADDAA AAAAADAD
